####################
#             ^# # #
# # ### #### # #F# #
# # #            # #
# # ### #### #####D#
#* %              ^#
####################