###############
# * * * * * *^#
#*## # # ## #*#
# $  #*#* $ # #
#*##*# # ####*#
# ## #*# * *  #
#*F *  ######*#
# ## #* ^ * * #
#*## # # ####D#
#   ^#*#*#* * #
#*#### # ####*#
# #  * *F#* * #
#*### ##### #*#
# %* *D * * * #
###############