###############
# * * * * * *^#
#*## # # # # *#
# ## #*#*#$#  #
#*##*# # ####*#
# ## #*# * *  #
#*F *  ######*#
# ## #* ^ * * #
#*## # # ####D#
# ##^#*#*#* * #
#*#### # ####*#
# #  * * * F# #
#*### #######*#
# %* *D * * * #
###############