#######
#*# *^#
# D*#*#
### * #
#* *#*#
#F* *%#
#######