####################
#* * * * * * *^#*#*#
# # ###*####*# #F#*#
#*# #* * * * * * #*#
# # ### #### #####D#
#* % * * * * * *  ^#
### ################