###############
#* * *#* * *^*#
#$# # # # #####
#*#*#* *#*# *$#
#^#F### # D*#*#
#* * * *#*# *^#
### ##### #####
#* * * *$ * * #
# ######## ####
#*D* * * #*#F*#
# ######D# #  #
#*#*F* *  %* *#
# ######*#### #
#* *^* * * * *#
###############