####################
#             ^# # #
#*# ### #### # #F# #
# #*#            # #
# # ### #### #####D#
#* %              ^#
####################