#########
#* * * %#
# ### ###
#*D^#* F#
#F#*# ###
#*# #* *#
#^#D### #
#* * *$*#
#########